   44444455555555
   99999900000000
   45678901234567
 0 ......+.......
 1 ............#.
 2 .#..#.......#.
 3 .#..#..#......
 4 .#..#..#......
 5 .#.....#......
 6 .#.....#......
 7 .#######......
 8 ..............
 9 ..............
10 ....#.....#...
11 ....#.....#...
12 ....#.....#...
13 ....#######...